28
29
1111111111111111111111111111
1000000000000110000000000001
1011110111110110111110111101
1011110111110110111110111101
1011110111110110111110111101
1000000000000000000000000001
1011110110111111110110111101
1011110110111111110110111101
1000000110000110000110000001
1111110111110110111110111111
1111110111110110111110111111
1111110110000000000110111111
1111110110222222220110111111
1111110110200000020110111111
3000000000200000020000000003
1111110110200000020110111111
1111110110222222220110111111
1111110110000000000110111111
1111110111110110111110111111
1111110111110110111110111111
1000000110000110000110000001
1011110110111111110110111101
1011110110111111110110111101
1000000000000000000000000001
1011110111110110111110111101
1011110111110110111110111101
1011110111110110111110111101
1000000000000110000000000001
1111111111111111111111111111