28
29
1111111111111111111111111111
1000000000000110000000000001
1011110111110110111110111101
1011110111110110111110111101
1011110111110110111110111101
1000000000000000000000000001
1011110110111111110110111101
1011110110111111110110111101
1000000110000110000110000001
1111110111110110111110111111
1111110111110110111110111111
1111110110000000000110111111
1111110110111221110110111111
1111110110100000010110111111
0000000000100000010000000000
1111110110100000010110111111
1111110110111111110110111111
1111110110000000000110111111
1111110111110110111110111111
1111110111110110111110111111
1000000110000110000110000001
1011110110111111110110111101
1011110110111111110110111101
1000000000000000000000000001
1011110111110110111110111101
1011110111110110111110111101
1011110111110110111110111101
1000000000000110000000000001
1111111111111111111111111111

5555555555555555555555555555
5444444444444554444444444445
5455554555554554555554555545
5655554555554554555554555565
5455554555554554555554555545
5444444444444444444444444445
5455554554555555554554555545
5455554554555555554554555545
5444444554444554444554444445
5555554555555555555554555555
5555554555555555555554555555
5555554555555555555554555555
5555554555555555555554555555
5555554555555555555554555555
5555554555555555555554555555
5555554555555555555554555555
5555554555555555555554555555
5555554555555585555554555555
5555554555555555555554555555
5555554555555555555554555555
5444444554444554444554444445
5455554554555555554554555545
5455554554555555554554555545
5444444444444444444444444445
5455554555554554555554555545
5655554555554554555554555565
5455554555554554555554555545
5444444444444554444444444445
5555555555555555555555555555