28
29
2222222222222222222222222222
2111111111111221111111111112
2122221222221221222221222212
2122221222221221222221222212
2122221222221221222221222212
2111111111111111111111111112
2122221221222222221221222212
2122221221222222221221222212
2111111221111221111221111112
2222221222221221222221222222
2222221222221221222221222222
2222221221111111111221222222
2222221221000000001221222222
2222221221011111101221222222
2111111111011111101111111112
2222221221011111101221222222
2222221221000000001221222222
2222221221111111111221222222
2222221222221221222221222222
2222221222221221222221222222
2111111221111221111221111112
2122221221222222221221222212
2122221221222222221221222212
2111111111111111111111111112
2122221222221221222221222212
2122221222221221222221222212
2122221222221221222221222212
2111111111111221111111111112
2222222222222222222222222222